111111111111111111111
1P00000000M0000000001
101111111101111111101
1C0000000M00000000001
100111000000011100001
100100000C00000100001
100100M00000M00100001
1C01000000000001000C1
100111110K01111100001
100000000E00000000001
111111111111111111111
