11111111111111111111
1P0C00000000000C0001
10111011111111011111
10000000C000000000C1
10111011111111011111
1C000000000000000001
11111111111111101111
10000000000000000001
11111111101111111111
10000000000000000001
1C1111111111111111C1
10000000000000000001
1C1111111111111111C1
100000000E0000000001
11111111111111111111
